name Pathfinder2
win 3
####################
#...............E..#
#...G..#.#.G.......#
#..#.###.###.##....#
#..#..........#....#
#..##..##.###.#....#
#...#..............#
#..G###.#######....#
#..............G...#
####################