name Pathfinder
win 3
####################
#...............E..#
#...G......G.......#
#..############....#
#..############....#
#..############....#
#...G..............#
#.............G....#
####################