name radiator - How smart is the SmartBot?
win 3
###################
#G...............G#
#.#.#.#.#.#.#.#.#.#
#.#.#.#.#.#.#.#.#.#
#.#.#.#.#.#.#.#.#.#
#.#.#.#.#E#.#.#.#.#
#.#.#.#.#.#.#.#.#.#
#.#.#.#.#.#.#.#.#.#
#.#.#.#.#.#.#.#.#.#
#G...............G#
###################