name Simple map
win 3
#########
#...G...#
#.......#
#...E...#
#G.....G#
#########