name win98
win 3
###################
#G...............G#
#.#######.#######.#
#.#######.#######.#
#.#######.#######.#
#........E........#
#.#######.#######.#
#.#######.#######.#
#.#######.#######.#
#G...............G#
###################